. @                  .
...........          .
........     !       .
........  ............
........  ............
........  ............
........  ............
......      ..........
......................