. @                  .
...........          .
........             .
........  ............
........  ............
........  ............
........  ............
......      ..........
......................